[
  {
    "type": "mapgen",
    "method": "json",
    "om_terrain": [ "s_butcher" ],
    "object": {
      "fill_ter": "t_dirt",
      "rows": [
        "bbbbbbbbbbbbbbbbbbbbbbbb",
        "bbbbbbbbbbbbbbbbbbbbbbbb",
        "nnnaddddddaeeaddddddannn",
        "nnnaffffffaccaffffffannn",
        "nnnahhhhhhhcccccccccannn",
        "nnnaccccccjcccccccccannn",
        "nnnakchccchcccccccccannn",
        "nnnakchccckcccccccccannn",
        "nnnakchccchcccccccccannn",
        "nnnakchccckcccccccccannn",
        "nnnakchccchcccccccccannn",
        "nnnacchccckcccccccccannn",
        "nnnacchccaaaaaaaaaaaannn",
        "nnnacccccecccccciiiiannn",
        "nnnaaaaaaaccccccccccannn",
        "nnnaccccccccccccccchannn",
        "nnnaccccccccccccccchannn",
        "nnnaccccccccclhhhhhhannn",
        "nnnaaaaaaaaaeaaaaaaaannn",
        "nnnnnnnnnnnnnmggggnnnnnn",
        "nnnnnnnnnnnnnnggggnnnnnn",
        "nnnnnnnnnnnnnnnnnnnnnnnn",
        "nnnnnnnnnnnnnnnnnnnnnnnn",
        "nnnnnnnnnnnnnnnnnnnnnnnn"
      ],
      "terrain": {
        "a": "t_wall",
        "b": "t_sidewalk",
        "c": "t_floor",
        "d": "t_wall_glass",
        "e": "t_door_c",
        "f": "t_floor",
        "g": "t_dirt",
        "h": "t_floor",
        "i": "t_floor",
        "j": "t_console_broken",
        "k": "t_floor",
        "l": "t_floor",
        "m": "t_dirt",
        "n": "t_grass",
        "o": "t_shrub"
      },
      "furniture": {
        "f": "f_table",
        "g": "f_dumpster",
        "h": "f_counter",
        "i": "f_fridge",
        "k": "f_rack",
        "l": "f_trashcan",
        "m": "f_trashcan"
      },
      "place_loot": [
        { "group": "groce_meat", "chance": 80, "repeat": [ 1, 2 ], "x": [ 4, 4 ], "y": [ 3, 3 ] },
        { "group": "groce_meat", "chance": 80, "repeat": [ 1, 2 ], "x": [ 5, 5 ], "y": [ 3, 3 ] },
        { "group": "groce_meat", "chance": 80, "repeat": [ 1, 2 ], "x": [ 6, 6 ], "y": [ 3, 3 ] },
        { "group": "groce_meat", "chance": 80, "repeat": [ 1, 2 ], "x": [ 7, 7 ], "y": [ 3, 3 ] },
        { "group": "groce_meat", "chance": 80, "repeat": [ 1, 2 ], "x": [ 8, 8 ], "y": [ 3, 3 ] },
        { "group": "groce_meat", "chance": 80, "repeat": [ 1, 2 ], "x": [ 9, 9 ], "y": [ 3, 3 ] },
        { "group": "groce_meat", "chance": 80, "repeat": [ 1, 2 ], "x": [ 14, 14 ], "y": [ 3, 3 ] },
        { "group": "groce_meat", "chance": 80, "repeat": [ 1, 2 ], "x": [ 15, 15 ], "y": [ 3, 3 ] },
        { "group": "groce_meat", "chance": 80, "repeat": [ 1, 2 ], "x": [ 16, 16 ], "y": [ 3, 3 ] },
        { "group": "groce_meat", "chance": 80, "repeat": [ 1, 2 ], "x": [ 17, 17 ], "y": [ 3, 3 ] },
        { "group": "groce_meat", "chance": 80, "repeat": [ 1, 2 ], "x": [ 18, 18 ], "y": [ 3, 3 ] },
        { "group": "groce_meat", "chance": 80, "repeat": [ 1, 2 ], "x": [ 19, 19 ], "y": [ 3, 3 ] },
        { "group": "groce_meat", "chance": 100, "repeat": [ 1, 2 ], "x": [ 10, 10 ], "y": [ 7, 7 ] },
        { "group": "groce_meat", "chance": 100, "repeat": [ 1, 2 ], "x": [ 10, 10 ], "y": [ 9, 9 ] },
        { "group": "groce_meat", "chance": 100, "repeat": [ 1, 2 ], "x": [ 10, 10 ], "y": [ 11, 11 ] },
        { "group": "groce_meat", "chance": 80, "repeat": [ 2, 5 ], "x": [ 16, 16 ], "y": [ 13, 13 ] },
        { "group": "groce_meat", "chance": 80, "repeat": [ 2, 5 ], "x": [ 17, 17 ], "y": [ 13, 13 ] },
        { "group": "groce_meat", "chance": 80, "repeat": [ 2, 5 ], "x": [ 18, 18 ], "y": [ 13, 13 ] },
        { "group": "groce_meat", "chance": 80, "repeat": [ 2, 5 ], "x": [ 19, 19 ], "y": [ 13, 13 ] },
        { "group": "groce_meat", "chance": 80, "repeat": [ 1, 2 ], "x": [ 19, 19 ], "y": [ 15, 17 ] },
        { "group": "groce_meat", "chance": 80, "repeat": [ 1, 2 ], "x": [ 18, 14 ], "y": [ 17, 17 ] },
        { "group": "trash", "chance": 100, "repeat": [ 1, 2 ], "x": [ 17, 14 ], "y": [ 19, 20 ] },
        { "group": "restaur_trash", "chance": 80, "repeat": [ 1, 2 ], "x": [ 13, 13 ], "y": [ 17, 17 ] },
        { "group": "restaur_trash", "chance": 80, "repeat": [ 1, 2 ], "x": [ 13, 13 ], "y": [ 19, 19 ] },
        { "group": "knifeblock", "chance": 100, "repeat": [ 2, 4 ], "x": [ 6, 6 ], "y": [ 6, 12 ] },
        { "group": "groce_meat", "chance": 80, "repeat": [ 1, 2 ], "x": [ 4, 4 ], "y": [ 6, 10 ] }
      ],
      "place_monsters": [ { "monster": "GROUP_ZOMBIE_FAT", "chance": 1, "repeat": [ 1, 3 ], "x": [ 9, 4 ], "y": [ 5, 13 ] } ]
    }
  }
]
