[
  {
    "type": "mapgen",
    "method": "json",
    "om_terrain": [ "house" ],
    "weight": 100,
    "object": {
      "fill_ter": "t_dirt",
      "rows": [
        "zzzzzzzzzzzzzzzzzzzzzzzz",
        "           zz           ",
        "           zz           ",
        "   aafgffaaihaaaaggaa   ",
        "   abdbdddabbarrbblla   ",
        "   abddddbabbkbbbbbba   ",
        "   asbdbbbabbabbbbbxa   ",
        "   arbbbbbabbabbbwbaa   ",
        "   aobbbbbhbbauuuvva    ",
        "   asmsnbbabbaaaaaaa    ",
        "   aaaaajaabbjbbttqa    ",
        "   abbbbbbabbabbbbbg    ",
        "   abwwbbbkbbassopra    ",
        "   awyyybbaahaaaaaaa    ",
        "   adyyybbbabbbbwvua    ",
        "   adddbbbbabbbbbbbg    ",
        "   aaffhggaaxddbbbbg    ",
        "   CCCCCCCCaddddbbba    ",
        "  CCDCCCCCCeddddbbba    ",
        "  CCECCCCCeecdbbllba    ",
        "  CCDCCCCCcacdbxllxa    ",
        "  CCCCCCCC aaaaaggaa    ",
        "   CC   CC              ",
        "                        "
      ],
      "terrain": {
        " ": [ "t_dirt", "t_grass", "t_grass", "t_grass" ],
        "a": "t_wall",
        "b": "t_floor",
        "c": "t_dirtmound",
        "d": "t_dirtfloor",
        "e": "t_dirtfloor",
        "f": "t_window_frame",
        "g": "t_window_domestic",
        "h": "t_door_b",
        "i": "t_door_locked",
        "j": "t_door_o",
        "k": "t_door_c",
        "l": "t_floor",
        "m": "t_floor",
        "n": "t_floor",
        "o": "t_floor",
        "p": "t_floor",
        "q": "t_floor",
        "r": "t_floor",
        "s": "t_floor",
        "t": "t_floor",
        "u": "t_floor",
        "v": "t_floor",
        "w": "t_floor",
        "x": "t_floor",
        "y": "t_floor",
        "z": "t_sidewalk",
        "A": "t_floor",
        "B": "t_floor",
        "C": "t_grass",
        "D": "t_grass",
        "E": "t_grass"
      },
      "furniture": {
        "e": "f_rubble",
        "l": "f_bed",
        "m": "f_oven",
        "n": "f_fridge",
        "o": "f_sink",
        "p": "f_toilet",
        "q": "f_shower",
        "r": "f_cupboard",
        "s": "f_counter",
        "t": "f_bathtub",
        "u": "f_bookcase",
        "v": "f_desk",
        "w": "f_chair",
        "x": "f_dresser",
        "y": "f_table",
        "A": "f_sofa",
        "D": "f_chair",
        "E": "f_table"
      },
      "place_monsters": [
        { "monster": "GROUP_FOREST", "chance": 1, "repeat": [ 2, 3 ], "x": [ 4, 9 ], "y": [ 19, 14 ] },
        { "monster": "GROUP_PEST", "chance": 1, "repeat": [ 2, 3 ], "x": [ 18, 14 ], "y": [ 11, 13 ] },
        { "monster": "GROUP_PEST", "chance": 2, "repeat": [ 3, 6 ], "x": [ 18, 12 ], "y": [ 3, 9 ] }
      ],
      "place_loot": [
        { "group": "kitchen", "chance": 80, "repeat": [ 3, 5 ], "x": [ 6, 4 ], "y": [ 14, 17 ] },
        { "group": "floor_trash", "chance": 80, "repeat": [ 1, 2 ], "x": [ 7, 7 ], "y": [ 14, 14 ] },
        { "group": "floor_trash", "chance": 80, "repeat": [ 5, 10 ], "x": [ 18, 12 ], "y": [ 3, 9 ] },
        { "group": "floor_trash", "chance": 80, "repeat": [ 1, 2 ], "x": [ 12, 11 ], "y": [ 11, 19 ] },
        { "group": "dining", "chance": 80, "repeat": [ 1, 2 ], "x": [ 7, 5 ], "y": [ 9, 10 ] },
        { "group": "floor_trash", "chance": 40, "repeat": [ 1 ], "x": [ 5, 4 ], "y": [ 8, 8 ] },
        { "group": "drugs_misc", "chance": 40, "repeat": [ 1, 2 ], "x": [ 18, 18 ], "y": [ 11, 11 ] },
        { "group": "floor_trash", "chance": 80, "repeat": [ 5, 10 ], "x": [ 16, 17 ], "y": [ 3, 4 ] },
        { "group": "floor_trash", "chance": 80, "repeat": [ 5, 10 ], "x": [ 19, 18 ], "y": [ 19, 19 ] },
        { "group": "dresser", "chance": 80, "repeat": [ 1 ], "x": [ 16, 14 ], "y": [ 15, 15 ] },
        { "group": "floor_trash", "chance": 80, "repeat": [ 5, 10 ], "x": [ 18, 18 ], "y": [ 3, 3 ] },
        { "group": "floor_trash", "chance": 80, "repeat": [ 5, 10 ], "x": [ 15, 15 ], "y": [ 3, 3 ] },
        { "group": "floor_trash", "chance": 50, "repeat": [ 5, 10 ], "x": [ 12, 12 ], "y": [ 7, 7 ] },
        { "group": "floor_trash", "chance": 80, "repeat": [ 2, 4 ], "x": [ 5, 9 ], "y": [ 19, 16 ] },
        { "group": "dresser", "chance": 80, "repeat": [ 1 ], "x": [ 19, 19 ], "y": [ 17, 17 ] }
      ]
    }
  }
]
