[
  {
    "type" : "mapgen",
    "om_terrain" : ["loffice_tower_12"],
    "method": "json",
    "weight": 250,
    "object": {
      "fill_ter": "t_floor",
      "rows": [
          "...DEEE|...|...+....|///",
          "...|EEE|...+...|.S.T|///",
          "...|-|-|---|...|----|///",
          ".....|c..rrV......ll|///",
          ".....|c....+...c....V///",
          "....^|ddd..V...x....V///",
          "HHHH-|-HHH-|...ccccc|///",
          "....................V///",
          "....................V///",
          "...............M....V///",
          "GHHH-|----|GG|--++--|///",
          ".....|ccSe|..|^....^V///",
          ".....|....|..|......V///",
          ".nnh.|.......|..ddxdV///",
          ".nnh.|.......|.....dV///",
          "nnnh.|hh...hh|l..oooV///",
          "nnnh.|nn...nn|+-+---|///",
          "hh...|nn...nn|.|.|;t|///",
          ".....|hh...hh|Q|.+;@|///",
          "HHHH-|-HHHHH-|--H---|///",
          "////////////////////////",
          "////////////////////////",
          "////////////////////////",
          "////////////////////////"
      ],
      "terrain": {
        "/": "t_open_air",
        "~": "t_rock",
        ">": "t_stairs_down",
        "<": "t_stairs_up",
        ".": "t_floor",
        " ": "t_dirt",
        "x": "t_console_broken",
        ",": "t_pavement_y",
        "_": "t_pavement",
        "%": "t_shrub",
        "+": "t_door_c",
        "{": "t_floor",
        ")": "t_floor",
        "}": "t_manhole_cover",
        "2": "t_utility_light",
        "b": "t_dirt",
        "c": "t_floor",
        "D": "t_door_metal_c",
        "d": "t_floor",
        "E": "t_elevator",
        "e": "t_floor",
        "G": "t_door_glass_c",
        "H": "t_wall_glass",
        "h": "t_floor",
        "I": "t_column",
        "k": "t_floor",
        "L": "t_floor",
        "l": "t_floor",
        "n": "t_floor",
        "o": "t_floor",
        "^": "t_floor",
        "p": "t_floor",
        "Q": "t_floor",
        "R": "t_railing_v",
        "r": "t_floor",
        "S": "t_floor",
        "s": "t_sidewalk",
        "T": "t_floor",
        "u": "t_floor",
        "V": "t_wall_glass",
        "X": "t_door_metal_locked",
        "z": "t_floor",
        "-": "t_wall",
        "|": "t_wall",
        ";": "t_linoleum_white",
        "t": "t_linoleum_white",
        "@": "t_linoleum_white"
      },
      "furniture": {
        "@": "f_bed",
        "{": "f_rubble",
        ")": "f_wreckage",
        "b": "f_bench",
        "c": "f_counter",
        "d": "f_desk",
        "e": "f_fridge",
        "h": "f_chair",
        "l": "f_locker",
        "n": "f_table",
        "o": "f_bookcase",
        "Q": "f_safe_l",
        "^": "f_indoor_plant",
        "r": "f_rack",
        "S": "f_sink",
        "T": "f_toilet",
        "U": "f_statue",
        "z": "f_crate_c"
      },
      "toilets" : {
          "t" : { }
      },
      "signs": {
        "M": {"snippet": "bs_lowyers_office" }
      },
      "npcs": {
        "@": {"class": "bs_npc_lowyer" }
      },
      "place_monsters": [
        {"monster": "BS_GROUP_LOWYERS_CLIENT", "x": [14,19], "y": [11,15], "density": 0.9}
      ],
      "place_vehicles": [
        {"vehicle": "swivel_chair", "x": 18, "y": 14, "rotation": 0, "chance": 90},
        {"vehicle": "swivel_chair", "x": 16, "y":  5, "rotation": 0, "chance": 90},
        {"vehicle": "swivel_chair", "x":  7, "y":  4, "rotation": 0, "chance": 90}
      ],
      "place_loot": [
         {"group": "textbooks"      , "chance": 75, "x": [ 9,10], "y": [ 3, 3], "repeat": [ 1, 3]}
        ,{"group": "office"         , "chance": 75, "x": [ 6, 8], "y": [ 5, 5], "repeat": [ 1, 3]}
        ,{"group": "office"         , "chance": 75, "x": [18,19], "y": [ 3, 3], "repeat": [ 1, 3]}
        ,{"group": "office"         , "chance": 75, "x": [16,17], "y": [13,13], "repeat": [ 1, 3]}
        ,{"group": "office"         , "chance": 75, "x": [19,19], "y": [13,14], "repeat": [ 1, 3]}
        ,{"group": "textbooks"      , "chance": 75, "x": [14,14], "y": [15,15], "repeat": [ 1, 3]}
        ,{"group": "dining"         , "chance": 75, "x": [ 6, 7], "y": [16,17], "repeat": [ 1, 3]}
        ,{"group": "dining"         , "chance": 75, "x": [11,12], "y": [16,17], "repeat": [ 1, 3]}
        ,{"group": "kitchen"        , "chance": 75, "x": [ 6, 7], "y": [11,11], "repeat": [ 1, 3]}
        ,{"group": "fridge"         , "chance": 75, "x": [ 9, 9], "y": [11,11], "repeat": [ 1, 3]}
        ,{"group": "office"         , "chance": 75, "x": [14,14], "y": [17,18], "repeat": [ 1, 3]}
        ,{"group": "office"         , "chance": 75, "x": [19,19], "y": [17,18], "repeat": [ 1, 3]}
        ,{"item" : "manual_speech"  , "chance": 75, "x": [17,17], "y": [15,15]}
        ,{"item" : "textbook_speech", "chance": 75, "x": [17,17], "y": [15,15]}
        ,{"item" : "mag_porn"       , "chance": 90, "x": [17,19], "y": [15,15], "repeat": [ 3, 8]}
        ,{"item" : "novel_erotic"   , "chance": 90, "x": [17,19], "y": [15,15], "repeat": [ 3, 8]}
        ,{"item" : "diamond"        , "chance":100, "x": [14,14], "y": [18,18], "repeat": [ 5,10]}
        ,{"item" : "cash_card"      , "chance":100, "x": [14,14], "y": [18,18], "repeat": [ 5,10]}
        ,{"item" : "money_bundle"   , "chance":100, "x": [14,14], "y": [18,18], "repeat": [60,90]}
        ,{"item" : "bondage_mask"   , "chance":100, "x": [14,14], "y": [18,18]}
        ,{"item" : "bullwhip"       , "chance":100, "x": [14,14], "y": [18,18]}
        ,{"item" : "vibrator"       , "chance":100, "x": [14,14], "y": [18,18]}
        ,{"item" : "candle"         , "chance":100, "x": [14,14], "y": [18,18]}
      ]
    }
  }
]
