[
  {
    "type": "mapgen",
    "om_terrain": ["police"],
    "method": "json",
    "weight": 100,
    "object": {
      "fill_ter" : "t_floor",
      "rows" : [
        ",____,____,ss,____,____,",
        ",____,____,ss,____,____,",
        ",____,____,ss,____,____,",
        "_ssssssssssssssssssssss_",
        "_-###-#==--OO-===-#=#--_",
        "_|[[[::::[w::w[::::[[[|_",
        "_|[::::::[w::w[::::::[|_",
        "_|[::::[[[w::w[[[::::[|_",
        "_|::::::::::::::::::::|_",
        "_|::cccXccXccXccXccccc|_",
        "_|::chh:hh:hh:hh:hh::K|_",
        "_|:::::::::::::::::::K|_",
        "_|*-----------------*-|_",
        "_|..|FFSS|LLLLL      W|_",
        "_|t.|           |*----|_",
        "_|---------*----- +  L|_",
        "_|T H bbbL| LL    |??L|_",
        "_|  /        adda ----|_",
        "_|B H Ca  |C adda    W|_",
        "_|-----------------*--|_",
        "_|_M___________C  %  r|_",
        "_|UM___________C@ /  U|_",
        "_|_M___________C  %  r|_",
        "_----------------------_"
      ],
      "terrain" : {
        "_": "t_pavement",
        ",": "t_pavement_y",
        "s": "t_sidewalk",
        "-": "t_wall",
        "|": "t_wall",
        "O": "t_door_metal_o",
        "+": "t_door_metal_locked",
        "*": "t_door_c",
        "=": "t_window_bars_alarm",
        "#": "t_window_bars",
        "H": "t_bars",
        "%": "t_chainfence_h",
        "/": "t_chaingate_c",
        ".": "t_linoleum_white",
        "t": "t_linoleum_white",
        ":": "t_linoleum_gray",
        "c": "t_linoleum_gray",
        "h": "t_linoleum_gray",
        "K": "t_linoleum_gray",
        "w": "t_linoleum_gray",
        "[": "t_linoleum_gray",
        "X": "t_console_broken",
        "M": "t_pavement",
        "U": "t_utility_light"
      },
      "furniture" : {
        "[": "f_sofa",
        "w": "f_indoor_plant_y",
        "W": "f_indoor_plant_y",
        "d": "f_desk",
        "h": "f_chair",
        "a": "f_chair",
        "c": "f_counter",
        "C": "f_counter",
        "r": "f_rack",
        "L": "f_locker",
        "K": "f_locker",
        "b": "f_bookcase",
        "S": "f_sink",
        "F": "f_fridge",
        "?": "f_safe_l",
        "B": "f_bed"
      },
      "toilets" : {
          "t" : { },
          "T" : { }
      },
      "npcs": {
        "@": {"class": "bs_npc_police_officer" }
      },
      "place_fields": [
        {"field": "fd_blood", "x":[ 2,18], "y":[ 0,11], "density": 3, "repeat": 20 }
      ],
      "monster": {
        "M": {"monster": "mon_ug_shooting_target"}
      },
      "place_monsters": [
        {"monster": "GROUP_HOUSE", "x": [ 3, 17], "y": [ 5,10], "density": 0.60}
      ],
      "place_loot" : [
         {"item" : "glass_shard"               , "chance": 20, "x": [ 2,18], "y": [ 3, 3], "repeat": [ 4, 8]}
        ,{"item" : "glass_shard"               , "chance": 80, "x": [ 2,18], "y": [ 3, 5], "repeat": [12,16]}
        ,{"item" : "9mm_casing"                , "chance": 70, "x": [ 2,21], "y": [ 1,11], "repeat": [16,48]}
        ,{"item" : "shot_hull"                 , "chance": 70, "x": [ 2,21], "y": [ 1,11], "repeat": [ 8,16]}
        ,{"group": "guns_pistol_common"        , "chance": 30, "x": [10,14], "y": [13,13], "repeat": [ 1, 2], "magazine": 100, "ammo": 100}
        ,{"group": "guns_shotgun_common"       , "chance": 30, "x": [10,14], "y": [13,13], "repeat": [ 1, 2], "magazine": 100, "ammo": 100}
        ,{"group": "cop_gear"                  , "chance": 75, "x": [10,14], "y": [13,13], "repeat": [ 1, 2]}
        ,{"group": "cop_gloves"                , "chance": 75, "x": [10,14], "y": [13,13], "repeat": [ 1, 2]}
        ,{"group": "cop_helmet"                , "chance": 75, "x": [10,14], "y": [13,13], "repeat": [ 1, 2]}
        ,{"group": "cop_pants"                 , "chance": 75, "x": [10,14], "y": [13,13], "repeat": [ 1, 2]}
        ,{"group": "cop_shoes"                 , "chance": 75, "x": [10,14], "y": [13,13], "repeat": [ 1, 2]}
        ,{"group": "cop_torso"                 , "chance": 75, "x": [10,14], "y": [13,13], "repeat": [ 1, 2]}
        ,{"group": "clothing_glasses"          , "chance": 75, "x": [10,14], "y": [13,13], "repeat": [ 1, 2]}
        ,{"group": "clothing_watch"            , "chance": 75, "x": [10,14], "y": [13,13], "repeat": [ 1, 2]}
        ,{"group": "cop_evidence"              , "chance": 75, "x": [21,21], "y": [15,16], "repeat": [ 2, 4]}
        ,{"item" : "9mm"                       , "chance": 90, "x": [19,20], "y": [16,16], "repeat": [ 1, 2]}
        ,{"item" : "45_jhp"                    , "chance": 90, "x": [19,20], "y": [16,16], "repeat": [ 1, 2]}
        ,{"item" : "shot_00"                   , "chance": 90, "x": [19,20], "y": [16,16], "repeat": [ 1, 2]}
        ,{"item" : "shot_slug"                 , "chance": 90, "x": [19,20], "y": [16,16], "repeat": [ 1, 2]}
        ,{"group": "fridge"                    , "chance":100, "x": [ 5, 6], "y": [13,13], "repeat": [ 2, 5]}
        ,{"group": "book_gunref"               , "chance": 50, "x": [ 6, 8], "y": [16,16], "repeat": [ 1, 2]}
        ,{"item" : "television"                , "chance":100, "x": [11,11], "y": [18,18]}
      ]
    }
  },

  {
    "//": "No NPC version.",
    "type": "mapgen",
    "om_terrain": ["police"],
    "method": "json",
    "weight": 300,
    "object": {
      "fill_ter" : "t_floor",
      "rows" : [
        ",____,____,ss,____,____,",
        ",____,____,ss,____,____,",
        ",____,____,ss,____,____,",
        "_ssssssssssssssssssssss_",
        "_-===-===--OO-===-===--_",
        "_|[[[::::[w::w[::::[[[|_",
        "_|[::::::[w::w[::::::[|_",
        "_|[::::[[[w::w[[[::::[|_",
        "_|::::::::::::::::::::|_",
        "_|::cccXccXccXccXccccc|_",
        "_|::chh:hh:hh:hh:hh::K|_",
        "_|:::::::::::::::::::K|_",
        "_|*-----------------*-|_",
        "_|..|FFSS|LLLLL      W|_",
        "_|t.|           |*----|_",
        "_|---------*----- +  L|_",
        "_|T H bbbL| LL    |??L|_",
        "_|  /        adda ----|_",
        "_|B H Ca  |C adda    W|_",
        "_|-----------------*--|_",
        "_|_M___________C  %  r|_",
        "_|UM___________C  /  U|_",
        "_|_M___________C  %  r|_",
        "_----------------------_"
      ],
      "terrain" : {
        "_": "t_pavement",
        ",": "t_pavement_y",
        "s": "t_sidewalk",
        "-": "t_wall",
        "|": "t_wall",
        "O": "t_door_metal_o",
        "+": "t_door_metal_locked",
        "*": "t_door_c",
        "=": "t_window_bars_alarm",
        "#": "t_window_bars",
        "H": "t_bars",
        "%": "t_chainfence_h",
        "/": "t_chaingate_c",
        ".": "t_linoleum_white",
        "t": "t_linoleum_white",
        ":": "t_linoleum_gray",
        "c": "t_linoleum_gray",
        "h": "t_linoleum_gray",
        "K": "t_linoleum_gray",
        "w": "t_linoleum_gray",
        "[": "t_linoleum_gray",
        "X": "t_console_broken",
        "M": "t_pavement",
        "U": "t_utility_light"
      },
      "furniture" : {
        "[": "f_sofa",
        "w": "f_indoor_plant_y",
        "W": "f_indoor_plant_y",
        "d": "f_desk",
        "h": "f_chair",
        "a": "f_chair",
        "c": "f_counter",
        "C": "f_counter",
        "r": "f_rack",
        "L": "f_locker",
        "K": "f_locker",
        "b": "f_bookcase",
        "S": "f_sink",
        "F": "f_fridge",
        "?": "f_safe_l",
        "B": "f_bed"
      },
      "toilets" : {
          "t" : { },
          "T" : { }
      },
      "monster": {
        "M": {"monster": "mon_ug_shooting_target"}
      },
      "place_loot" : [
         {"group": "guns_pistol_common"        , "chance": 30, "x": [10,14], "y": [13,13], "repeat": [ 1, 2], "magazine": 100, "ammo": 100}
        ,{"group": "guns_shotgun_common"       , "chance": 30, "x": [10,14], "y": [13,13], "repeat": [ 1, 2], "magazine": 100, "ammo": 100}
        ,{"group": "cop_gear"                  , "chance": 75, "x": [10,14], "y": [13,13], "repeat": [ 1, 2]}
        ,{"group": "cop_gloves"                , "chance": 75, "x": [10,14], "y": [13,13], "repeat": [ 1, 2]}
        ,{"group": "cop_helmet"                , "chance": 75, "x": [10,14], "y": [13,13], "repeat": [ 1, 2]}
        ,{"group": "cop_pants"                 , "chance": 75, "x": [10,14], "y": [13,13], "repeat": [ 1, 2]}
        ,{"group": "cop_shoes"                 , "chance": 75, "x": [10,14], "y": [13,13], "repeat": [ 1, 2]}
        ,{"group": "cop_torso"                 , "chance": 75, "x": [10,14], "y": [13,13], "repeat": [ 1, 2]}
        ,{"group": "clothing_glasses"          , "chance": 75, "x": [10,14], "y": [13,13], "repeat": [ 1, 2]}
        ,{"group": "clothing_watch"            , "chance": 75, "x": [10,14], "y": [13,13], "repeat": [ 1, 2]}
        ,{"group": "cop_evidence"              , "chance": 75, "x": [21,21], "y": [15,16], "repeat": [ 2, 4]}
        ,{"item" : "9mm"                       , "chance": 90, "x": [19,20], "y": [16,16], "repeat": [ 1, 2]}
        ,{"item" : "45_jhp"                    , "chance": 90, "x": [19,20], "y": [16,16], "repeat": [ 1, 2]}
        ,{"item" : "shot_00"                   , "chance": 90, "x": [19,20], "y": [16,16], "repeat": [ 1, 2]}
        ,{"item" : "shot_slug"                 , "chance": 90, "x": [19,20], "y": [16,16], "repeat": [ 1, 2]}
        ,{"group": "fridge"                    , "chance":100, "x": [ 5, 6], "y": [13,13], "repeat": [ 2, 5]}
        ,{"group": "book_gunref"               , "chance": 50, "x": [ 6, 8], "y": [16,16], "repeat": [ 1, 2]}
        ,{"item" : "television"                , "chance":100, "x": [11,11], "y": [18,18]}
      ]
    }
  }
]
